NO    ./img/cat.xpm
SO ./img/dog-2.xpm
WE ./img/grass.xpm
EA ./img/home.xpm

F      250,25,200
C     1,    100,   111

      11111111111111111111111111
      10000001110000000000000001
11111110000000000000000000000011
10000000000000000000000000001111
100000000N00000011100000000011
100000000000000000000000000001
111111111111111111111111111111
