NO ./img/home.xpm
SO ./img/dog-2.xpm
WE ./img/grass.xpm
EA ./img/home.xpm

C     1,    100,   111
F  254,25,0

     11111111111111111111111111111
     11000000000000000000000000011
1111111000000000S0000000000000011
100000000000000000000001111011111
1000000000000000111000011 10011
100000000000000000000001111001
111111111111111111111111111111
