NO ./img/home.xpm
SO ./img/dog-2.xpm
WE ./img/grass.xpm
EA ./img/home.xpm

C     1,    100,   111
F  254,25,0

     11111111111111111111111111111
     1110000001110000000000000001
111111100000000000000000000000011
10000000000000000000000111101111
1000000N00000000111000011 10011
100000000000000000000001111001
111111111111111111111111111111
