NO    ./img/brick.xpm
SO ./img/blue.xpm
WE ./img/wood.xpm
EA ./img/grey.xpm

F      250,25,200
C     1,    10,   111

      11111111111111111111111111
      10000000000000000000000001
11111110000000000000000000000011
10000000000000001000000000001111
1000000000000W000000000000001
10000000000000000000000000001
11111111111111111111111111111
