NO ./img/greystone.xpm
SO ./img/purplestone.xpm
WE ./img/redbrick.xpm
EA ./img/wood.xpm

C     1,    100,   111
F  254,25,0

     11111111111111111111111111111
     11N00000000000000000000000011
111111100000000000000000000000011
100000000000000000000001111011111
1000000000000000111000011 10011
100000000000000000000001111001
111111111111111111111111111111
