NO    ./img/brick.xpm
SO ./img/blue.xpm
WE ./img/wood.xpm
EA ./img/grey.xpm

F 250,25,200
C 1,10,100

         1111111111111
11    111111100000000111111111
111111111000000001111111011111
100000000000111000000000001110111
1000000000001 100000000001100111
11111110000011100000000000000001
10000000000000000000000000001111
1000000000000W000000000000001
10000000000000000000000000001
11111111111111111111111111111



    1
   111
  11011
 1100011
110000011
 1100011
  11011
   111
    1